name	img_url
内閣情報調査室	
小池百合子	https://upload.wikimedia.org/wikipedia/commons/8/8f/Yuriko_Koike_cropped.jpg
松井一郎	https://upload.wikimedia.org/wikipedia/commons/b/b2/Ichiro_Matsui_Ishin_IMG_5775_20130713.JPG
内閣府	
経済産業省	
吉村洋文	
内閣官房	
厚生労働省	
さいたま市	
法務省	
福島県	
年金積立金管理運用独立行政法人	
大阪府	
最高検察庁	
防衛省	
特定複合観光施設区域整備推進本部	
内閣情報保全監察室	
内閣人事局	
東京教育委員会	
警視庁	
文部科学省	
東京都福祉保健局	
京都市	
東京都中央卸売市場	
東京都オリンピック・パラリンピック準備局	
東京都環境局	
東京都港湾局	
東京都政策企画局	